NO ./textures/test/north.xpm
SO ./textures/test/south.xpm
WE ./textures/test/wesst.xpm
EA ./textures/test/eastt.xpm

F 212,163,115
C 113,142,187

111111
100001
10E00111
10000001
11111111