NO ./textures/test/north.xpm
SO ./textures/test/south.xpm
WE ./textures/test/west.xpm
EA ./textures/test/east.xpm
DR ./textures/doors/wooddoor.xpm
DF ./textures/doors/wallgate.xpm
X  ./textures/enemys/obunga.xpm

F 212,163,115
C 113,142,187

                   11111111111111111
               111100000000E000000001111
            1110000000000000000000000000111
         1110000000000000000000000000000000111
       111000000000000000000000000000000000000111
     1100000000000000000000000000000000000000000011
    110000000000000000000000000000000000000000000011
   11000000000000000011111110111111100000000000000011
  1100000000000000010000000000000000010000000000000011
 110000000000000000100000000000000000100000000000000011
11000000000000000001000000000000000001000000000000000011
11000000000000000001000000000000000001000000000000000011
1100000000000000000000000001D100000000000000000000000011
11000000000000000001000000000000000001000000000000000011
11000000000000000001000000000000000001000000000000000011
11000000000000000001000000000000000001000000000000000011
11100000000000000001000000000000000001000000000000000011
 111000000000000000001111111011111110000000000000000011
  1110000000000000000000000000000000000000000000000011
   11100000000000000000000000000000000000000000000011
    111000000000000000000000000000000000000000000011
     1110000000000000000000000000000000000000000011
       111000000000000000000000000000000000000011
         11000000000000000000000000000000000111
           111100000000000000000000000001111
               11110000000000000000X1111
                   11111111111111111