NO ./textures/metal/metal1.xpm
SO ./textures/metal/metal2.xpm
WE ./textures/metal/metal3.xpm
EA ./textures/metal/metal4.xpm
DR ./textures/doors/metaldoor.xpm
DF ./textures/doors/metalgate2.xpm
X  ./textures/enemys/chinwi.xpm
F 207,175,123
C 156,184,250


1111111111111111111111111111111111111
1N00000011111100000000D00000110000001
1D1D11101000D001111D1111111D11D111101
101010101110111  110100000D0D00100101
10101110D000011  1101111111D11D100101
10100000111D1111111110000000110100D01
10D01D11 10000110000001111111100001D1
1111101111000011D11110110100011111101
100000000D000100010010110000000000101
1D11111D11D11100010010111111111110101
10100X0011011100011D101    1    10101
11111111111111111110101   101   10101
100000000000000000D01011  101  111001
1011111111111111111010111 101 1110001
1D1100D0D000011111111D11111D111100001
1001111011111110000000000000000D00001
100D000000000000111111111111111100001
11111111101111111111111111111111D1111
        11D00000000000000000000001
        11111111111111111111111111