NO ./textures/jungle/fantasy.xpm
SO ./textures/jungle/fantasy.xpm
WE ./textures/jungle/fantasy1.xpm
EA ./textures/jungle/grass2.xpm

F 212,163,115
C 113,142,187

        11111          1111111111     
        10N01          1000000001       
        10001111111111110111111011111111
     111100000000000000001    1000000001 
     100000000001111111111    1111111101 
     101111111100111111111111        101
     101      100000000000001   11111101
     101      100111111111101   10000001
     101      1001        101   10111101
     1011111111001        101   10100101
     1011000000001        101   10110101
     1011011001101        101   10110101
     101101100110111111111101   10000101
     101101100110000000000001   11111101
     101101000011111111111111        101
     10110100000000000001       11111101   
     10110100011111101111       10000001
     1011010101    101          10111111    
     101101010111111011111111111101   
     101100010000000000000000000001   
     1011111111111110111111111111011  
     101           101          1001  
     101           101          11011 
     101           101           1001      1111111111111
     101          10001          11011     1000000000001
     101         1000001          1001     1000000100001
     101        100010001         1101111111000001110001
     101       10001110001         100000000000000100001
     101      1000110110001        101111111000000000001
     10111111100011000110001       101     1000000100001
     101100000000000000000001      101     1000001110001
     101101111111111111111111111111101     1000000100001
     100000000000000000000000000000001     1000000000001
     111111111111111111111111111111111     1111111111111
