NO ./textures/brick-wall_.xpm
SO ./textures/brick-wall_.xpm
WE ./textures/eagle.xpm
EA ./textures/eagle.xpm
F 207,175,123
C 156,184,250


11111
11011
10N01
11011
11111