NO ./path_to_the_north_texture
SO ./path_to_the_south_texture
WE	./path_to_the_west_texture	 
EA ./path_to_the_east_texture
F	207,175,123
C 156,184,255

111111111
100000001
100000001
100W00001
100000001
100000001
100000001
100010001
100100001
101000001
110000001
100000001
100000001
111111111
111110111
