NO ./textures/brick-wall_.xpm
SO ./textures/brick-wall_.xpm
WE ./textures/eagle.xpm
EA ./textures/eagle.xpm
DR ./textures/door1.xpm
DF ./textures/wood2.xpm
X  ./textures/obunga.xpm
F 207,175,123
C 156,184,250


1111111
100X001
1000001
1000001
1000001
101N001
1100001
1000011
1000101
1001001
1010001
1000001
1110001
1010001
1011001
1001101
1000001
1011111
1000001
1111101
1000001
1100011
1110111
1110111
1110111
1100011
1000001
1100011
1110101
1110101
1110001
1111111
