
NO ./path_to_the_north_texture
SO ./path_to_the_south_texture
WE ./path_to_the_west_texture
EA ./path_to_the_east_texture
F 207,175,123
C 156,184,250

111111
100001
100001
100W01
100001
100001
100001
100001
100001
100001
100001
100001
100001
111111
