NO ./textures/stone/stone2.xpm
SO ./textures/stone/stone1.xpm
WE ./textures/stone/stone4.xpm
EA ./textures/stone/stone3.xpm
DR ./textures/doors/metaldoor.xpm
DF ./textures/doors/metalgate.xpm
X  ./textures/enemys/obunga.xpm

F 207,175,123
C 156,184,250



11111111111111111111111111111111111111111111111111111111111
1000000000110000000000011000000X110000000000000000000000DN1
10111111011111110011110000111111100111100011111110111110111
100000001000000000000000100000000000000000100000000000111
111111111110111111100000000000001111111110111101111100001
100000000000000001110111111111100000000000000000000111101
101101111111110111000000100011111011111110111111111000011
101101110001110111010100001011110010000100111111101110001
101100000001110111000000110000000000111001000000000010101
101000011000000011011000000000000000000110001111111111101
101000111101110011010111100111111111000000001000000000001
101110000001000000011110000000010001111111111000011111101
100100100001000000000000000010000100000000000000010000001
110111110011111111111111110011111111111111111111110111111
100000000000000000000011000000000000000000000000010000001
100111111111111111101111111100011111111011111111111111111
100001100101000100000000010001010000000010001100001000001
100011000001010001000110010101011111000011100001001001001
10011001110111111111111111110100000111001111110100100100111
10000011010000000000000000000100000000000000000100000100D01
11111111111111111111111111111111111111111111111111111111111