NO ./textures/brick-wall_.xpm
SO ./textures/brick-wall_.xpm
WE ./textures/eagle.xpm
EA ./textures/eagle.xpm
DR ./textures/door1.xpm
DF ./textures/wood2.xpm
X  ./textures/vini_cry.xpm

F 207,175,123
C 156,184,250

111111111111111111111111111111111111111111111111111111111
1E0000000000000000000000000000000000000000000000000000X01
111111111111111111111111111110111111111101111111111111101
100000000000000000000000000010000000000000000000000000001
10000000000000000000000000001111111111111D111111111111101
100000000000000000000000000000010000000000000000000000001
100000000000000000000000000000010110111111111111111111101
100000000000000000000000000000010000100000000000000000001
100000000000000000000000000000011111100111100111111110001
100000000000000000000000000000000000000000000000100000001
100000000000000000000000000000000000000000000000100010001
100000000000000000000000000000000000000000000011000110001
100000000000000000000000000000000000000000000000000000001
100000000000000000000000000000000000000000000000000000001
100000000000000000000000000000000000000000000000000000001
100000000000000000000000000000000000000000000000000000001
100000000000000000000000000000000000000000000000000000001
100000000000000000000000000000000000000000000000000000001
100000000000000000000000000000000000000000000000000000001
100000000000000000000000000000000000000000000000000000001
100000000000000000000000000000000000000000000000000000001
100000000000000000000000000000000000000000000000000000001
100000000000000000000000000000000000000000000000000000001
100000000000000000000000000000000000000000000000000000001
100000000000000000000000000000000000000000000000000000001
111111111111111111111111111111111111111111111111111111111
