NO ./textures/brick-wall_.xpm
SO ./textures/brick-wall_.xpm
WE ./textures/eagle.xpm
EA ./textures/eagle.xpm

F 207,175,123
C 156,184,250

111111111111111111
100000000000000001
101111111111111101
101            101
101            101
101   111111111101
101   100S00000001
101   100000000001
101   100000000001
101111110100110011
101000100000011111
10001111000111
1011000000111
100000110011
111111111111
