NO ./textures/jungle/grass1.xpm
SO ./textures/jungle/grass2.xpm
WE ./textures/jungle/grass3.xpm
EA ./textures/jungle/grass4.xpm
DR ./textures/doors/door1.xpm
DF ./textures/wood/wood2.xpm
X  ./textures/enemys/vini_cry.xpm

F 207,175,123
C 156,184,250

111111111111111111111111111111111111111111111111111111111
1E0000000000000000000000000000000000000000000000000000X01
111111111111111111111111111110111110111101111111111111101
10000000000000001 100011000010000000000000000000000000001
10101010101100001 101011000011110111011110111111110111101
100010101000001011100000000000000110000000000000000000001
100000001011101000000111111000010110010110000111110110001
1011011000111000011001111110100000000100000001   10110001
101100001000001100000000000010011111000101100111110110001
100001100000100000011101111010011111000001100000000000001
100000001110101100000001  1010000000011101100011100110001
101010100000100001010101  1000001100000001100011100110001
100010100100001000000101111001001100110000000000000000001
101000000101101001100000000011100000000011111001100100001
101010110101101001101111000001000000111011111001100100001
100010000100000000001  10011000110001 1000000001100100001
101000000000100110001111001101011000111010011101100001101
10000001111010011101000000000101100000001001 100001100001
10110001  10000110010101101110000011111010011101100001101
100001011110010000000100000000011000000000000000001100001
110000000000010111110000100001011001111011110010001000101
10010111011000000000011010010000000000001  10010100010001
110101 10000110010000110000001101101000011110000101000001
100101110110110010000000001101100001011000000110001011001
110000000000000000001001000000001100000001100000000000001
111111111111111111111111111111111111111111111111111111111
