NO ./textures/test/north.xpm
SO ./textures/test/south.xpm
WE ./textures/test/west.xpm
EA ./textures/test/east.xpm
DR ./textures/door1.xpm
DF ./textures/wood2.xpm
F 207,175,123
C 156,184,250


11111111111
10S00000001
10001111111
10001
10001
10001111111
10000000001
10001111111
10001
10001
10001111111
10000000001
11111111111
