NO ./textures/NO.xpm
SO ./textures/SO.xpm
WE ./textures/WE.xpm
EA ./textures/EA.xpm
F 207,175,123
C 156,184,250


11111111
100000W1
10000001
10000001
10000001
10000001
10000001
11111111
