NO ./textures/brick-wall_.xpm
SO ./textures/brick-wall_.xpm
WE ./textures/eagle.xpm
EA ./textures/eagle.xpm
DR ./textures/door1.xpm
DF ./textures/wood2.xpm
X  ./textures/obunga.xpm
F	207,175,123
C 156,184,255

1111111111111111
1000000000000001
1000E000000X0001
1000000000000001
1000000000000001
1000000000000001
1000000000000001
1000000000000001
1000000000000001
1000000000000001
1000000000000001
1000000000000001
1000000000000001
1111111111111111