NO ./textures/test/north.xpm
SO ./textures/test/south.xpm
WE ./textures/test/west.xpm
EA ./textures/test/east.xpm
DR ./textures/door1.xpm
DF ./textures/wood2.xpm
X  ./textures/obunga.xpm
F	207,175,123
C 156,184,255

11111
1E1X1
11111
