        1111111111111111111111111
        100000000D10000000000001
        1011000001110000000000001
        100D000000000000000000001
111111111D11000001110000000000001
1000000000ED000001110111111111111
11110111111111011100000010001
111101111111110111010100D0101
11000000110101011100000011001
10000000000000001100000000001
10000000000000001101010010001
11000001110101011111011110001
11110111 1110101 101111010001
11111111 1111111 111111111011
        1111111111111111110111111111111111111111111111111
        100000000D10000000000001000000000D10000000000001
        101100000111000000000000010000001110000000000001
        100D00000000000000000000100000000000000000000001
111111111D1100000111000000000000111111111D11000001110001
10000000000D000001110111111111111000000000D0000011100001
11110111111111011100000010001111110111111111101110000001
111101111111110111010100D0101111011111111110111010101001
11000000110101011100000011001100000011010101111000000001
10000000000000001100000000001100000000000000000000000001
10000000000000001101010010001100000000000000001101010001
11000001110101011111011110001100000111010101111101111001
11111111 1110101 10111101000111110111 1110101 10111101001
111111111111111111111111111111111111111111111111111111111