NO ./textures/brick-wall_.xpm
SO ./textures/brick-wall_.xpm
WE ./textures/eagle.xpm
EA ./textures/eagle.xpm
DR ./textures/door1.xpm
DF ./textures/wood2.xpm
X  ./textures/obunga.xpm

F 207,175,123
C 156,184,250


111111111111111111111111111111111111111111111111111111111
100000000D100000000000010000X000D100000000000000000000001
1011111101111111001111100011111110111110000111111111111N1
100000001000000000000000100000000000000000100000000000111
11111111111D1111111000000000000111111111111111D1111100001
100000000000000001110111111111100000000000000000000111101
111101111111110111000000100011111011111111111111111000011
111101111111110111010100D01011110111111111111111101110001
111100000000010111000000110000000000110000000000000010101
100000000000000011011000000000000000000000001111111111101
100000011101110011010111100111111111000000001000000000001
111110000000000000011110000000000001111111111000000011111
100000000000000000000000000000000000000000000000000000001
111111000011111111111110000011111111111111111110011111111
10000D000000000000000011000000000000000000000000000000001
1000011111111111111D1111111100011111111000011111111111101
100000000000000000000000000001000000000010000000000000001
111111111111111111111111111111111111111111111111111111111
