NO ./textures/brick-wall_.xpm
SO ./textures/brick-wall_.xpm
WE ./textures/eagle.xpm
EA ./textures/eagle.xpm
F 207,175,123
C 156,184,250


        1111111111111111111111111
        100000000D10000000000001
        1011000001110000000000001
        100D000000000000000000001
111111111D11000001110000000000001
1000000000ED000001110111111111111
11110111111111011100000010001
111101111111110111010100D0101
11000000110101011100000011001
10000000000000001100000000001
10000000000000001101010010001
11000001110101011111011110001
11110111 1110101 101111010001
11111111 1111111 111111111111