NO ./textures/brick-wall_.xpm
SO ./textures/brick-wall_.xpm
WE ./textures/eagle.xpm
EA ./textures/eagle.xpm
DR ./textures/door1.xpm
DF ./textures/wood2.xpm

F 207,175,123
C 156,184,250


        111111111111111111111111111111111111111111111111111111111
        100000000D1000000000000100000000D100000000000000000000001
        1011111101111111001111100011111110111110000111111111111N1
        100000001000000000000000100000000000000000100000000000111
11111111111D1111111000000000000111111111111111D111110000000111111
100000000000000001110111111111100000000000000000000111100011
111101111111110111000000100011111011111111111111111000011111
111101111111110111010100D01011110111111111111111101110101001
11110000000001011100000011000000000011000000000000001010001
10000000000000001101100000000000000000000000111111111110001
10000001110111001101011110011111111100000000100000000000001
11111000000000000001111000000000000111111111100000001111111
10000000000000000000000000000000000000000000000000000000001
11111100001111111111111000001111111111111111111001111111001
10000D00000000000000001100000000000000000000000000000000001
1000011111111111111D1111111100011111111000011111111111101D1
10000000000000000000000000000100000000001000000000000000101
11111111111111111111111111111111111111111111111111111111111
