NO ./path_to_the_north_texture
SO ./path_to_the_south_texture
WE	./path_to_the_west_texture	 
EA ./path_to_the_east_texture
F	207,175,123
C 156,184,255

11111111111111111111
10000000000000000001
10000000000000000001
11110000000111111111
11100000000000000011
11000000000000011111
10000000011100000011
10000000000000000001
100N0000000000000111
10000000000000000111
10011100000000000001
10010100000000000001
10011100000000000001
11100011111100000111
10000000000000000011
10000000000000000001
10000000011000000001
10000000001000000111
10000000001000000011
11111111111111111111