NO ./textures/brick-wall_.xpm
SO ./textures/brick-wall_.xpm   
WE ./textures/eagle.xpm
EA ./textures/eagle.xpm
DR ./textures/door1.xpm
DF ./textures/wood2.xpm
X  ./textures/obunga.xpm
F 207,175,123
C 156,184,250

11111111111111111111
10D000000000D0000001
11100000000010000001
11110000000111111D11
11100000000000000011
110000001D1000011111
100000001E1000000011
10000000101000000001
10000000101000000011
10000000101000000111
100111001D1000000001
100101001X1000000001
10011100000000000001
11100011111100000111
10000000000000000011
10000000000000000001
10000000011000000001
100000000010000001D1
10000000001000000101
11111111111111111111
